team,Wins,Losses,Map Wins,Map Losses,Map Delta,Round Wins,Round Losses,Round Delta
BBL Esports,3,2,6,5,1,121,106,15
FNATIC,3,2,6,5,1,122,108,14
FUT Esports,3,1,7,3,4,122,94,28
GIANTX,1,4,5,8,-3,127,154,-27
Gentle Mates,2,2,4,4,0,74,80,-6
KOI,0,4,1,8,-7,71,113,-42
Karmine Corp,3,3,9,7,2,175,160,15
Natus Vincere,3,1,7,4,3,125,102,23
Team Heretics,3,2,7,5,2,136,125,11
Team Liquid,2,3,5,7,-2,117,138,-21
Team Vitality,3,2,6,7,-1,133,143,-10
